STATE PROGRAM PARTICIPATION – ELEVATE & CFLN

✅ ALLOWED STATES

ELEVATE PROGRAM STATES
AK – Alaska  
AL – Alabama  
AR – Arkansas  
AZ – Arizona  
CA – California  
FL – Florida  
IN – Indiana  
LA – Louisiana  
MI – Michigan  
MS – Mississippi  
MO – Missouri  
NE – Nebraska  
NM – New Mexico  
NY – New York  
NC – North Carolina  
OK – Oklahoma  
SD – South Dakota  
TX – Texas  
UT – Utah  

CFLN / ATTORNEY-REPRESENTED STATES
CO – Colorado  
CT – Connecticut  
DE – Delaware  
GA – Georgia  
HI – Hawaii  
IA – Iowa  
ID – Idaho  
IL – Illinois  
KS – Kansas  
KY – Kentucky  
MA – Massachusetts  
MD – Maryland  
ME – Maine  
MN – Minnesota  
MT – Montana  
NH – New Hampshire  
NJ – New Jersey  
NV – Nevada  
OH – Ohio  
PA – Pennsylvania  
PR – Puerto Rico  
RI – Rhode Island  
SC – South Carolina  
TN – Tennessee  
VA – Virginia  
WV – West Virginia  
VT – Vermont  
WY – Wyoming  
DC – District of Columbia

📌 All above states support the Fresh Start Plan (FSP) with a 27% fee structure.

🚫 STATES NOT SERVICED
❌ MN – Minnesota (except Clarity RevShare 15%)
❌ OR – Oregon  
❌ WA – Washington  
❌ WI – Wisconsin

NOTE:
- OH & NJ: ❌ No direct mail allowed
- CO: ❌ Fresh Start Plan NOT offered. Clients can optionally pay for legal defense.